segm	segm
i	i 
e	e 
eh	eh 
a	a 
oh	oh 
o	o 
u	u 
iN	iN 
eN	eN 
aN	aN
oN	oN 
uN	uN 
I	I 
E	E 
A	A 
O	O 
U	U 
IN	IN 
EN	EN 
AN	AN 
ON	ON 
UN	UN 
eI	eI 
ehI	ehI
aI	aI 
ohI	ohI 
oI	oI 
uI	uI 
aNI	aNI 
oNI	oNI 
iU	iU 
eU	eU 
ehU	ehU 
aU	aU 
ohU	ohU
oU	oU 
aNU	aNU 
IU	IU 
IO	IO 
UU	UU 
UO	UO 
II	II 
IE	IE 
UI	UI 
UE	UE 
IA	IA 
UA	UA
ANU	ANU 
p	p 
t	t 
k	k 
b	b 
d	d 
g	g 
f	f 
s	s 
sh	sh 
v	v 
z	z 
zh	zh 
S	S
m	m 
n	n 
nh	nh 
r	r 
R	R 
l	l 
lh	lh